11111111111111111111111111
1000000P00000000C0000V0001
1000000000E0000C0000000001
1000V00000000V0000V0000001
1V00000000V000000C00000001
11111111111111111111111111
