












            1111111111111       
            100000P011C01         
            1C0V00E001V01        
            1CV000C000C01        
            1111111111111           









