1111111111
1P0C00V0C1
11V0C000E1
1111111111
